################
################
################
#..#.....#.....#
#..#..........##
#.......#......<
#.##..........##
##.........#...#
################
