################
################
################
#..#.....#2.....
#..#..........##
#.......#......<
#.##......1...##
##.........#...#
################
