######..........
#...s#..........
#....#..........
#...s#..........
######..........
................
................
................
................
