................
................
################
#..............#
#..............#
#.......#......<
#..............#
#..............#
################
