################
################
################
#..#.....#......
#..#..........##
#.......#......<
#.##..........##
##.........#...#
################
