################
################
################
#..#.....#.....#
#..#..........##
#.......#......<
#.##..........##
##.....1...#...#
################
