################
################
################
##....#........E
##....##########
##....#........E
################
################
################