#v###.##v#######
#.######.#######
#.##############
#..#.....#.....#
#..............#
#..#....#......#
#..............#
##.............#
########.#####^#
