................
................
################
##....#........<
##....##########
##....#........<
################
################
################