
#######vv#######
################
################
#..............#
#..............#
#..............#
################
################
#######^^#######