#####v##########
################
#.......#......<
#.......#......<
#.......#......<
#.....##########
#....###########
#...############
################
