###.############
....############
################
##....#........<
##....##########
##....#........<
################
###......#######
########.#######
