################
...1############
###.############
##....#........<
##....##########
##....#........<
###.############
###2.....#######
########.#######
