###vvv####vvv###
##########...###
###...##########
#.#......#.....#
#......#......##
##......#.....##
...............#
##.............#
###...####...#.#
