###vvv####vvv###
##########...###
###...##########
#.#......#.....#
#......#......##
##......#.....##
#..............#
##.............#
###...####...###