#####v##########
################
........#......<
#.......#......<
#.......#......<
#.....##########
#....###########
#..#.###########
#.##.###########
