#####v######.###
############.###
#.......#......<
#.......#......<
#.......#......<
#.....##########
#....####.......
#..#.####.######
#########.######
