#####v######.###
############.###
#.......#......<
#.......#......<
#.......#......<
#.....######.###
#....####2..1###
#..#.####.######
#########.######
