2.s####vv####s##
##.####ss####.##
################
#..............#
#..............#
#..............#
################
##.####ss####.##
##s####^^####s.2
