##s####vv####s##
##.####ss####.##
################
#..............#
#..............#
#..............#
################
##.####ss####.##
##s####^^####s##