#.###########.v#
#.###########..#
#..............#
#..............#
#..........##..#
###......####.s<
################
#..#..........s#
####.....#######
