#.###########.v#
#.###########..#
#..............#
#..............#
#..........##..#
.1#......####.s<
################
#..#..........s#
####.....#######
