#v#v##v##v##v#v#
##2.22.33.22.2##
#.#.##.##.##.#.#
................
#.############.#
................
###.##.##.##.###
##............##
################
