##3#############
3.s...#s#...##.#
###..##.####...<
#..s...s.....#.#
#....s###s3#...#
#..s..##.......#
###...#...#.#..<
3.s..###..#....#
##3#############
